:Secret place
000000000000000000000000000000
000000000000000000000000000000
000000000000000000000000000000
000000000000000000000000000000
00000000000000T000000000000000
GGG000000000000000000000000000
GGG000000000000000000000000000
GGG00000000000000000000000GGGG
GGGG00000000000000000000ggGGGG
GGGG00000000000000000000GGGGGG
GGGG000000000000000000g0GGGGGG
GGGG000P00000000000000GGGGGGGG
GGGG--GGG-------------GGGGGGGG
GGGGwwGGGwwwwwwwwwGGGGGGGGGGGG
GGGGGGGGGGGGGGGwwwGGGGGGGGGGGG
GGGGGGGGGGGGGGGGGGGGGGGGGGGGGG
GGGGGGGGGGGGGGGGGGGGGGGGGGGGGG
