:SWORD II: ADVENTURE OF FROG
:arrow keys + X/C
:stick + A/X
000000000000000000000000000000
000000000000000000000000000000
000000000000000000000000000000
000000000000000000000000000000
000000|0000000T000000000000000
000000|00000000000000000000000
000000|00000I00L111000000000##
GG0000|00000I00L00000000000###
GG-000|###00I00L00000000000###
GG0000|###00I00L00I000000BB###
GG-000|####0I00LL0I0000--11111
GGgggg|####PIggLL0Ig00###11111
GGGGGGGGG11111GGGGGGGGGGGGGGGG
GGGGGGGGG11111GGGGGGGGGGGGGGGG
GGGGGGGGGGGGGGGGGGGGGGGGGGGGGG
GGGGGGGGGGGGGGGGGGGGGGGGGGGGGG
GGGGGGGGGGGGGGGGGGGGGGGGGGGGGG
