:SWORD II: ADVENTURE OF FROG
:arrow keys + X/C
:stick + A/X
000000000000000000000000000000
000000000000000000000000000000
000000000000000000000000000000
000000000000000000000000000000
00000000000000T000000000000000
000000000000000000000000000000
000000000000I000I00000000000##
GG00I0000000I00II0000000000###
GG-0I00###00I00II0000000000###
GG00I00###00I00II0I000000BB###
GG-0I00####0I00II0I0000--11111
GGggIg0####PIggII0Ig00###11111
GGGGGGGGG11111GGGGGGGGGGGGGGGG
GGGGGGGGG11111GGGGGGGGGGGGGGGG
GGGGGGGGGGGGGGGGGGGGGGGGGGGGGG
GGGGGGGGGGGGGGGGGGGGGGGGGGGGGG
GGGGGGGGGGGGGGGGGGGGGGGGGGGGGG
