:SWORD II: ADVENTURE OF FROG
:arrow keys + X/C
:stick + A/X
000000000000000000000000000000
000000000000000000000000000000
000000000000000000000000000000
000000000000000000000000000000
000000I0000000T000000000000000
000000I00000000000000000000000
000000I00000I000I00000000000##
GG0000I00000I00II0000000000###
GG-000I###00I00II0000000000###
GG0000I###00I00II0I000000BB###
GG-000I####0I00II0I0000--11111
GGggggI####PIggII0Ig00###11111
GGGGGGGGG11111GGGGGGGGGGGGGGGG
GGGGGGGGG11111GGGGGGGGGGGGGGGG
GGGGGGGGGGGGGGGGGGGGGGGGGGGGGG
GGGGGGGGGGGGGGGGGGGGGGGGGGGGGG
GGGGGGGGGGGGGGGGGGGGGGGGGGGGGG
