000000000000000000000000000000
000000000000000000000000000000
000000000000000000000000000000
000000000000000000000000000000
000000000000000000000000000000
000000000000000000000000000000
00000000000000000000000000###0
0000000000000000000000000#####
0000000000000000000000000###11
0000000000000000000M00000###11
##000000001111000000##00000#11
###P00ggg01111ggg00###0000gg11
GGGGGGGGGGGGG111GGG1110001111G
GGGGGGGGGGGGGGGGGGGG11##01111G
GGGGGGGGGGGGGGGGGGGG11##-11GGG
GGGGGGGGGGGGGGGGGGG111###11GGG
GGGGGGGGGGGGGGGGGGG111###11GGG
